20
20
44444444444444444444
44444440000444444444
44444400000044444444
44440000000000044444
44440060060600044444
44440006060060044444
44440000333000044444
44440003000300044444
44440033000330044444
44440006060600044444
44440060000060044444
44440000606000044444
44440004444004044444
44440600000006044444
44440006060600044444
44440006000600044444
44444400000444444444
44444440000444444444
44444440000444444444
44444444444444444444 