32
32
55555555555555555555555555555555
55555555555555555555555555555555
55555555555555555555555555555555
55555555555555555555555555555555
55553333333333333333333333335555
55553333333333333333333333335555
55553333333333333333333333335555
55553333070333303333333073335555
55553333300033303003333003335555
55553333333333333303333333335555
55553333033333333333330333335555
55553333333307333333333333335555
55553333333300033333333333335555
55553330333333333333000333335555
55553300333333333333033333335555
55553333333333333333333333335555
55553333333300733333003333335555
55553333333300033333333333335555
55553333030333333333333330335555
55553333333333333333333330335555
55553073333333333333333333335555
55553003333333333333733333335555
55553333333333330333003333335555
55553333333333330333333333335555
55553333333333333333333333335555
55553333333333333333703333335555
55553333333333333333003333335555
55553333333333333333333333335555
55555555555555555555555555555555
55555555555555555555555555555555
55555555555555555555555555555555
55555555555555555555555555555555
