24
24
333333333333333333333333
333333333333333333333333
333333333333333333333333
333300000003300000033333
333300020003300200033333
333300000003300000033333
333300000003300000033333
333333330333333033333333
333300000000000000033333
333300002222222000033333
333300002000002000033333
333300002000002000033333
333300002000002000033333
333300002222022000033333
333300000000000000033333
333333330000000033333333
333333330003000033333333
333300000003300000033333
333300000003300000033333
333300000003300000033333
333333333333333333333333
333333333333333333333333
333333333333333333333333
333333333333333333333333
333333333333333333333333 